..............................
.                            .
.     .................      .
.     .................      .
.       .............        .
.       .............        .
.         .........          .
.         .........          .
.    ...................     .
.    ...................     .
.   .....................    .
.   .....................    .
.   .....................    .
.         .........          .
.         .........          .
.         .........          .
.         .........          .
.         .........          .
.   .....................    .
.   .....................    .
.   .....................    .
.    ...................     .
.    ...................     .
.         .........          .
.         .........          .
.       .............        .
.       .............        .
.     .................      .
.     .................      .
.                            .
..............................
